
NO ./textures/Moss.xpm     
SO ./textures/kora.xpm
WE ./textures/METAL.xpm
EA ./textures/mramor.xpm


S ./textures/geralt.xpm


F 0  ,   255 ,   0  
C      0 , 00000000000000000000000000255,  255


R 000000000000000000000000000000000000001280 800



        1111111111111111111111111 111111
        1000000000110000000222221
        1011000001110000002222221
        1001000000000000000222221
111111111011000001110000000022221
100000000011000001110011111111111
11110111111111011100000010001
11100011111111011101010010001
11S00000110101011100000010001
10002000000000001100000010001
10022222200000001101010010001
11022221110101011111011110011
11112111 1110101 101111010001
11111111 1111111 111111111111
111111111
