
NO ./textures/kora.xpm     
SO ./textures/kora.xpm
WE ./textures/mramor.xpm
EA ./textures/mramor.xpm


S1 ./textures/geralt.xpm
S2 ./textures/yennefer.xpm
S3 ./textures/zirilla.xpm
S4 ./textures/svitok.xpm
S5 ./textures/heart.xpm
S6 ./textures/mramor.xpm
S7 ./textures/wolf.xpm
S8 ./textures/monstr.xpm


F 0  ,   255 ,   0  
C      0 , 00000000000000000000000000255,  255


R 000000000000000000000000000000000000001280 960



        1111111111111111111111111
        1000000000110000100010001
        1011000001111001000100301
        1061000000000000100010111
111111111011000001111000000000001
100000000011000001110011111111111
11110111111111011100000010001
11100011111111011101010010001
11000000110101011100000070001
1000S000000000001101100010001
10000000000000001101000010001
11000001110101011191011010011
11112111 1110101 151618010041
11111111 1111111 111111111111
111111111
